!! 統計学及び機械学習用語辞書 for ATOK

あっぷさんぷりんぐ	アップサンプリング	名詞*
あかいけじょうほうりょうきじゅん	赤池情報量規準	名詞*
あそしえーしょんぶんせき	アソシエーション分析	名詞*
あだぶーすと	アダブースト	名詞*
あふぃんしゅうごう	アフィン集合	名詞*
あふぃんふへん	アフィン不変	名詞*
あぷりおり	アプリオリ	名詞*
あやまりていせいしゅつりょくふごう	誤り訂正出力符号	名詞*
あやまりはっけんりつ	誤り発見率	名詞*
あんさんぶる	アンサンブル	名詞*
あんさんぶるがくしゅう	アンサンブル学習	名詞*
あんすう	暗数	名詞*
いぇんせんのふとうしき	イェンセンの不等式	名詞*
いったいいち	一対一	名詞*
いったいぜん	一対全	名詞*
いっぱんかいーえむ	一般化ＥＭ	名詞*
いっぱんかかほうてきもでる	一般化加法的モデル	名詞*
いっぱんかこうさかくにん	一般化交差確認	名詞*
いっぱんかせんけいもでる	一般化線形モデル	名詞*
いじょうけんち	異常検知	名詞*
いじんぐもでる	イジングモデル	名詞*
いつだつど	逸脱度	名詞*
いつだつどぶんせき	逸脱度分析	名詞*
いてれーたー	イテレーター	名詞*
いどうへいきんもでる	移動平均モデル	名詞*
いんし	因子	名詞*
いんしふか	因子負荷	名詞*
いんしぶんせき	因子分析	名詞*
うぇーぶれっと	ウェーブレット	名詞*
うぉるふそうついもんだい	ウォルフ双対問題	名詞*
うめこみがた	埋め込み型	名詞*
えきすぱーと	エキスパート	名詞*
えこしすてむ	エコシステム	名詞*
えらすてぃっくねっと	エラスティックネット	名詞*
えんとろぴー	エントロピー	名詞*
おーぷんでーた	オープンデータ	名詞*
おうとうへんすう	応答変数	名詞*
おぞん	オゾン	名詞*
おぶじぇくとかんひるいじど	オブジェクト間非類似度	名詞*
おんがくせいせい	音楽生成	名詞*
おんせいごうせい	音声合成	名詞*
おんせいしょり	音声処理	名詞*
おんせいにんしき	音声認識	名詞*
かっせいかかんすう	活性化関数	名詞*
かーねるかんすう	カーネル関数	名詞*
かーねるしゅせいぶんぶんせき	カーネル主成分分析	名詞*
かーねるほう	カーネル法	名詞*
かいき	回帰	名詞*
かいきかんすう	回帰関数	名詞*
かいきすぷらいん	回帰スプライン	名詞*
かいきぶんせき	回帰分析	名詞*
かいきもんだい	回帰問題	名詞*
かいすうていげんがたせんけいはんべつぶんせき	階数低減型線形判別分析	名詞*
かいそうてきえきすぱーとこんごうもでる	階層的エキスパート混合モデル	名詞*
かいそうてきくらすたりんぐ	階層的クラスタリング	名詞*
かいついせきあるごりずむ	解追跡アルゴリズム	名詞*
かかい	下界	名詞*
かかいか	下界化	名詞*
かかいさいだいかあるごりずむ	下界最大化アルゴリズム	名詞*
かがくしゅう	過学習	名詞*
かぎゃくあっしゅく	可逆圧縮	名詞*
かくさんがうすぶんぷ	拡散ガウス分布	名詞*
かくしんど	確信度	名詞*
かくにんしゅうごう	確認集合	名詞*
かくりつかてい	確率過程	名詞*
かくりつしつりょうかんすう	確率質量関数	名詞*
かくりつてききんじ	確率的近似	名詞*
かくりつてきこうばいこうかほう	確率的勾配降下法	名詞*
かくりつてきこうばいぶーすてぃんぐ	確率的勾配ブースティング	名詞*
かくりつてきたんさく	確率的探索	名詞*
かくれちょうてん	隠れ頂点	名詞*
かくれゆにっと	隠れユニット	名詞*
かしょうてきごう	過少適合	名詞*
かしか	可視化	名詞*
かじゅう	荷重	名詞*
かじゅうげんすい	荷重減衰	名詞*
かじゅうしょうきょ	荷重消去	名詞*
かそうかんきょう	仮想環境	名詞*
かてごりかるへんすう	カテゴリカル変数	名詞*
かてごりがたのよそくへんすう	カテゴリ型の予測変数	名詞*
かてごりがたへんすう	カテゴリ型変数	名詞*
かへんけいりょうほう	可変軽量法	名詞*
かほうてきもでる	加法的モデル	名詞*
かほうてきろじすてぃっくかいきもでる	加法的ロジスティック回帰モデル	名詞*
かるーしゅきゅーんたっかーじょうけん	カルーシュ＝キューン＝タッカー条件	名詞*
かるまんふぃるた	カルマンフィルタ	名詞*
かんすう	関数	名詞*
かんすうきんじ	関数近似	名詞*
かんぜんでーた	完全データ	名詞*
かんそくぞうほうりょう	観測情報量	名詞*
かんど	感度	名詞*
かんれんどじどうけってい	関連度自動決定	名詞*
かんれんねっとわーく	関連ネットワーク	名詞*
がうしあんのいずでーた	ガウシアンノイズデータ	名詞*
がうすにゅーとんほう	ガウス＝ニュートン法	名詞*
がうすまるこふていり	ガウス＝マルコフ定理	名詞*
がくしゅうき	学習器	名詞*
がくしゅうずみもでる	学習済みモデル	名詞*
がくしゅうべくとるりょうしか	学習ベクトル量子化	名詞*
がくしゅうりつ	学習率	名詞*
がぞうしょり	画像処理	名詞*
がぞうせいせい	画像生成	名詞*
がぞうぶんるい	画像分類	名詞*
がぞうへんかん	画像変換	名詞*
がふうへんかん	画風変換	名詞*
がふうへんかんもでる	画風変換モデル	名詞*
きょうかがくしゅう	強化学習	名詞*
きょうし	教師	名詞*
きょうしあり	教師あり	名詞*
きょうしありがくしゅう	教師あり学習	名詞*
きょうしありがくしゅうもんだい	教師あり学習問題	名詞*
きょうしなし	教師なし	名詞*
きょうしなしがくしゅう	教師なし学習	名詞*
きょうしなしがくしゅうもんだい	教師なし学習問題	名詞*
きょうちょうふぃるたりんぐ	協調フィルタリング	名詞*
きょうやくこうばいほう	共役勾配法	名詞*
きょくしょあやまりはっけんりつ	局所誤り発見率	名詞*
きょくしょかいき	局所回帰	名詞*
きょくしょさいてきかい	局所最適解	名詞*
きょくしょせんけいうめこみ	局所線形埋め込み	名詞*
きょくしょたじげんしゃくどこうせいほう	局所多次元尺度構成法	名詞*	loal linear embedding; LLE	しない
きょくしょゆうど	局所尤度	名詞*
きかいがくしゅう	機械学習	名詞*
きかいほんやく	機械翻訳	名詞*
きたいにじょうよそくごさ	期待二乗予測誤差	名詞*
きたいよそくごさ	期待予測誤差	名詞*
きたいりどくさいだいかせんりゃく	期待利得最大化戦略	名詞*
きていかんすう	基底関数	名詞*
きていてんかい	基底展開	名詞*
きのおおきさ	木の大きさ	名詞*
ぎゃっぷとうけいりょう	ギャップ統計量	名詞*
ぎゃくでんぱん	逆伝搬	名詞*
ぎゃくでんぱんとうしき	逆伝搬等式	名詞*
ぎょうしゅうがた	凝集型	名詞*
ぎょうれつえんざん	行列演算	名詞*
ぎいんせい	偽陰性	名詞*
ぎいんせいりつ	偽陰性率	名詞*	false negative rate; FNR	しない
ぎようせい	偽陽性	名詞*
ぎようせいりつ	偽陽性率	名詞*	false positive rate; FPR	しない
くぶんてきたこうしき	区分的多項式	名詞*
くみあわせあるごりずむ	組み合わせアルゴリズム	名詞*
くらうど	クラウド	名詞*
くらすかるしぇぱーどのたじげんしゃくどこうせいほう	クラスカル＝シェパードの多次元尺度構成法	名詞*
くらすかんきょうぶんさんぎょうれつ	クラス間共分散行列	名詞*
くらすかんぶんさん	クラス間分散	名詞*
くらすないきょうぶんさんぎょうれつ	クラス内共分散行列	名詞*
くらすないぶんさん	クラス内分散	名詞*
くりーく	クリーク	名詞*
くれんじんぐ	クレンジング	名詞*
くろすしゅうけい	クロス集計	名詞*
くんれんえぽっく	訓練エポック	名詞*
くんれんごさ	訓練誤差	名詞*
くんれんしゅうごう	訓練集合	名詞*
くんれんでーた	訓練データ	名詞*
くんれんひょうほんがいごさ	訓練標本外誤差	名詞*
くんれんひょうほんないごさ	訓練標本内誤差	名詞*
ぐらふぃかるもでる	グラフィカルモデル	名詞*
ぐらふぃかるらっそ	グラフィカルラッソ	名詞*
ぐらふのかしか	ぐらふの可視化	名詞*
ぐらふらぷらしあん	グラフラプラシアン	名詞*
ぐらむしゅみっとのちょっこうかほう	グラム＝シュミットの直交化法	名詞*
ぐるーぷらっそ	グループラッソ	名詞*
けっそんち	欠損値	名詞*
けっそんでーた	欠損データ	名詞*
けっていきょうかい	決定境界	名詞*
けっていぎ	決定木	名詞*
けいすうへんかもでる	係数変化モデル	名詞*
けいたいそかいせき	形態素解析	名詞*
けんしゅつりつ	検出率	名詞*
げーとねっとわーく	ゲートネットワーク	名詞*
げーむ	ゲーム	名詞*
げんけいぶんせき	原型分析	名詞*
こーどぶっく	コードブック	名詞*
こうごさようすぷらいん	交互作用スプライン	名詞*
こうさえんとろぴー	公差エントロピー	名詞*
こうさかくにん	公差確認	名詞*
こうさけんしょう	交差検証	名詞*
こうしひょうじ	格子表示	名詞*
こうじげんにおけるきょくしょかいほう	高次元における局所解法	名詞*
こうぞうかかいきもでる	構造化回帰モデル	名詞*
こうぞうてきりすくさいしょうか	構造的リスク最小化	名詞*
こうたいあてはめほう	後退当てはめ法	名詞*
こうばいこうかほう	勾配降下法	名詞*
こうばいぶーすてぃんぐ	勾配ブースティング	名詞*
こうばいぶーすてぃんぐもでる	勾配ブースティングモデル	名詞*
こうばいほう	勾配法	名詞*
こうれべるえーぴーあい	高レベルＡＰＩ	名詞*
こえしつへんかん	声質変換	名詞*
こじんじょうほうほごほう	個人情報保護法	名詞*
こじんぞくせいじょうほう	個人属性情報	名詞*
こすととふくざつどによるえだかり	コストと複雑度による枝刈り	名詞*
こてんてきたじげんしゃくどこうせいほう	古典的多次元尺度構成法	名詞*
こみゅにけーしょんのうりょく	コミュニケーション能力	名詞*
こゆうちぶんかい	固有値分解	名詞*
こんごうがうすぶんぷ	混合ガウス分布	名詞*
こんごうはんべつぶんせき	混合判別分析	名詞*
こんごうぶんぷにおけるぎぶすひょうほんちゅうしゅつき	混合分布におけるギブス標本抽出器	名詞*
こんごうもでる	混合モデル	名詞*
こんごうもでるといーえむあるごりずむ	混合モデルとＥＭアルゴリズム	名詞*
こんじょいんとぶんせき	コンジョイント分析	名詞*
こんどうぎょうれつ	混同行列	名詞*	confusion matrix	しない
ごうぎ	合議	名詞*
ごうぎほう	合議法	名詞*
ごさにもとづくもでる	誤差に基づくモデル	名詞*
ごぶんるいごさ	誤分類誤差	名詞*
ごぶんるいりつ	誤分類率	名詞*
さいきゅうこうかほう	最急降下法	名詞*
さいきんぼうしゅくしょうじゅうしんほう	最近傍縮小重心法	名詞*
さいきんぼうじゅうしん	最近傍重心	名詞*
さいしょうかくかいき	最小角回帰	名詞*
さいしょうきじゅつりょう	最小記述量	名詞*
さいしょうにじょうごさ	最小二乗誤差	名詞*
さいしょうにじょうほう	最小二乗法	名詞*
さいじゃくりんくえだかり	最弱リンク枝刈り	名詞*
さいせいかくひるべるとくうかん	再生核ヒルベルト空間	名詞*
さいぜんど	最善度	名詞*
さいだいきたいりどく	最大期待利得	名詞*
さいてきか	最適化	名詞*
さいてきすこあづけ	最適スコア付け	名詞*
さいてきぶんりちょうへいめん	最適分離超平面	名詞*
さいひんちたんさくき	最頻値探索器	名詞*
さいぶん	細分	名詞*
さいゆうすいてい	最尤推定	名詞*
さくげんふのうごさ	削減不能誤差	名詞*
さぽーとべくとるぶんるいき	サポートベクトル分類器	名詞*
さぽーとべくとるましん	サポートベクトルマシン	名詞*
さまりのかきだし	サマリの書き出し	名詞*
さもんまっぷ	サモンマップ	名詞*
さんぷず	散布図	名詞*
ざひょうこうかほう	座標降下法	名詞*
ざんさにじょうわ	残差二乗和	名詞*
しゃえいついせき	射影追跡	名詞*
しゃえいついせきかいき	射影追跡回帰	名詞*
しゅうごうち	集合知	名詞*
しゅきょくせんとしゅきょくめん	主曲線と主曲面	名詞*
しゅくしょう	縮小	名詞*
しゅくしょうりつ	縮小率	名詞*
しゅせいぶん	主成分	名詞*
しゅせいぶんぶんせき	主成分分析	名詞*
しゅつりょく	出力	名詞*
しゅつりょくそう	出力層	名詞*
しゅてん	主点	名詞*
しゅわるつのきじゅん	シュワルツの規準	名詞*
しきいち	閾値	名詞*
しぐもいどかんすう	シグモイド関数	名詞*
しぐもいどにゅーろん	シグモイドニューロン	名詞*
しじおうとうきょうれつ	指示応答行列	名詞*
しじてきでーたぶんせき	指示的データ分析	名詞*
しじど	支持度	名詞*
しすてむのせいぎょ	システムの制御	名詞*
しつてきへんすう	質的変数	名詞*
しろくろしゃしん	白黒写真	名詞*
しんえぬぴーもんだい	新ＮＰ問題	名詞*
しんそうがくしゅう	深層学習	名詞*
しんらいど	信頼度	名詞*
じぇねれーたー	ジェネレーター	名詞*
じゃくがくしゅうき	弱学習器	名詞*
じゃんくしょんつりー	ジャンクションツリー	名詞*
じゅうかいきぶんせき	重回帰分析	名詞*
じゅうぞくへんすう	従属変数	名詞*
じゅうてんひょうほんか	重点標本化	名詞*
じゅうてんひょうほんかがたがくしゅうあんさんぶる	重点標本化型学習アンサンブル	名詞*
じゅけいず	樹形図	名詞*
じゅしんしゃどうさとくせいきょくせん	受信者動作特性曲線	名詞*
じゅんかいせーるるまんもんだい	巡回セールスマン問題	名詞*
じゅんじょしゃくど	順序尺度	名詞*
じゅんじょつきかてごりがたへんすう	順序付きカテゴリ型変数	名詞*
じゅんでんばんがたにゅーらるねっとわーく	順伝搬型ニューラルネットワーク	名詞*
じゅんにゅーとんほう	準ニュートン法	名詞*
じょいんつりー	ジョインツリー	名詞*
じょうかい	上界	名詞*
じょうかいか	上界化	名詞*
じょうかいさいしょうかあるごりずむ	上界最小化アルゴリズム	名詞*
じょうけんつきゆうど	条件付き尤度	名詞*
じょうたいくうかんもでる	状態空間モデル	名詞*
じっけんけいかく	実験計画	名詞*
じっこうかのうかい	実行可能解	名詞*
じけいれつ	時系列	名詞*
じけいれつでーた	時系列データ	名詞*
じげんののろい	次元の呪い	名詞*
じこかいきいどうへいきんもでる	自己回帰移動平均モデル	名詞*
じこかいきもでる	自己回帰モデル	名詞*
じこかいきわぶんいどうへいきん	自己回帰和分移動平均モデル	名詞*
じこそしきかまっぷ	自己組織化マップ	名詞*
じこむむじゅんんせい	自己無矛盾性	名詞*
じごかくりつ	事後確率	名詞*
じごぶんぷ	事後分布	名詞*
じしょによるほうほう	辞書による方法	名詞*
じぜんぶんぷ	事前分布	名詞*
じつげんち	実現値	名詞*
じどうちゃくしょく	自動着色	名詞*
じどうちゃくしょくきのう	自動着色機能	名詞*
じにしすう	ジニ指数	名詞*
すいじゅん	水準	名詞*
すいろん	推論	名詞*
すうりょうかいちるい	数量化Ⅰ類	名詞*
すうりけいかくほう	数理計画法	名詞*
すきっぷこねくしょん	スキップコネクション	名詞*
すけーるへんかん	スケール変換	名詞*
すこあかんすう	スコア関数	名詞*
すこあほうていしき	スコア方程式	名詞*
すたっきんぐ	スタッキング	名詞*
すたっくはんか	スタック汎化	名詞*
すてーくほるだー	ステークホルダー	名詞*
すてーくほるだーまっぷ	ステークホルダーマップ	名詞*
すとりーむこんぴゅーてぃんぐ	ストリームコンピューティング	名詞*
すとれすかんすう	ストレス関数	名詞*
すぱーすねす	スパースネス	名詞*
すぱむ	スパム	名詞*
すぷらいん	スプライン	名詞*
すぺくとるくらすたりんぐ	スペクトルクラスタリング	名詞*
すむーじんぐ	スムージング	名詞*
せってん	節点	名詞*
せっぺん	切片	名詞*
せいきほうてきしき	正規方程式	名詞*
せいげんつきすいていほう	制限付き推定法	名詞*
せいじゅんへんりょう	正準変量	名詞*
せいそくか	正則化	名詞*
せいそくかきせき	正則化軌跡	名詞*
せいそくかはんべつぶんせき	正則化判別分析	名詞*
せぐめんてーしょん	セグメンテーション	名詞*
せつきょり	接距離	名詞*
せつめいてきでーたぶんせき	説明的データ分析	名詞*
せつめいへんすう	説明変数	名詞*
せみぱらめとりっく	セミパラメトリック	名詞*
せみぱらめとりっくとうけい	セミパラメトリック統計	名詞*
せんけいかいき	線形回帰	名詞*
せんけいかいきもでる	線形回帰モデル	名詞*
せんけいきていてんかい	線形基底展開	名詞*
せんけいけいかくもんだい	線形計画問題	名詞*
せんけいはんべつぶんせき	線形判別分析	名詞*
せんけいはんべつもでる	線形判別モデル	名詞*
せんけいふぃるたもでる	線形フィルタモデル	名詞*
せんけいぶんりかのう	線形分離可能	名詞*
せんけいへいかつか	線形平滑化	名詞*
せんけいもでるとさいしょうにじょうほう	線形モデルと最小二乗法	名詞*
せんざいくらすもでる	潜在クラスモデル	名詞*
せんもんそしきがた	専門組織型	名詞*
ぜったいちごさ	絶対値誤差	名詞*
ぜんけつごうそう	全結合層	名詞*
ぜんりつせんとくいこうげん	前立腺特異抗原	名詞*
そうかんるーる	相関ルール	名詞*
そうきょくせんせいせつかっせいかかんすう	双曲線正接活性化関数	名詞*
そうきていし	早期停止	名詞*
そうべつぎゃくかいきほう	層別逆回帰法	名詞*
そぐらふ	疎グラフ	名詞*
そしゅせいぶんぶんせき	疎主成分分析	名詞*
そふとしきいちしょり	ソフト閾値処理	名詞*
そふとまっくすかんすう	ソフトマックス関数	名詞*
そんしつかんすう	損失関数	名詞*
そんしつぎょうれつ	損失行列	名詞*
たいいきまるこふせい	大域マルコフ性	名詞*
たいこうぶんぷ	多項分布	名詞*
たいすうおっず	対数オッズ	名詞*
たいすうせんけいもでる	対数線形モデル	名詞*
たいすうゆうど	対数尤度	名詞*
たいわしすてむ	対話システム	名詞*
たいわぶんせいせい	対話文生成	名詞*
たぐちめそっど	タグチ・メソッド	名詞*
たこうろじっともでる	多項ロジットモデル	名詞*
たじゅうかせつけんてい	多重仮説検定	名詞*
たじゅうかほうてきかいきき	多重加法的回帰木	名詞*
たじゅうせんけいかいきもでる	多重線形回帰モデル	名詞*
たじげんきゅーぶ	多次元キューブ	名詞*
たじげんしゃくどこうせいほう	多次元尺度構成法	名詞*
たじげんしゅつりょく	多次元出力	名詞*
たじげんはいれつ	多次元配列	名詞*
たすうけつ	多数決	名詞*
たそうぺーせぷとろん	多層パーセプトロン	名詞*
たたみこみそう	畳み込み層	名詞*
たたみこみねっとわーく	畳み込みネットワーク	名詞*
たへんりょうてきおうてきかいきすぷらいん	多変量適応的回帰スプライン	名詞*
たへんりょうのんぱらめとりっくかいき	多変量ノンパラメトリック回帰	名詞*
たんいつしひょうもでる	単一指標モデル	名詞*
たんかいきもでる	単回帰モデル	名詞*
たんごべくとる	単語ベクトル	名詞*
たんさくてきしゃえいついせきほう	探索的射影追跡法	名詞*
たんじゅんべいず	単純ベイズ	名詞*
たんたいほう	単体法	名詞*
たんちょうらっそ	単調ラッソ	名詞*
たんへんすうせんたく	単変数選択	名詞*
だいがえへんすう	代替変数	名詞*
だいきぼがぞうでーたせっと	大規模画像データセット	名詞*
だみーへんすう	ダミー変数	名詞*
だんかいてき	段階的	名詞*
だんつぃくせんたくき	ダンツィク選択器	名詞*
ちぇんじまねーじめんと	チェンジマネージメント	名詞*
ちゃんねる	チャンネル	名詞*
ちゅうかんそう	中間層	名詞*
ちょっこうひょう	直交表	名詞*
ちょうかいぞう	超解像	名詞*
ちょうやくげんていほう	跳躍限定法	名詞*
ちょさくけんほう	著作権法	名詞*
ちてきざいさんけん	知的財産権	名詞*
ついまるこふぐらふ	対マルコフグラフ	名詞*
ついまるこふせい	対マルコフ性	名詞*
ついまるこふどくりつせい	対マルコフ独立性	名詞*
ていじょうてき	定常的	名詞*
ていすう	定数	名詞*
てきおうがたはんべつぶんせき	適応型判別分析	名詞*
てきおうてきさいきんぼうほう	適応的最近傍法	名詞*
てきおうてきしゅだん	適応的手段	名詞*
てきおうてきらっそ	適応的ラッソ	名詞*
てきごうりつ	適合率	名詞*
てすとごさ	テスト誤差	名詞*
てすとしゅうごう	テスト集合	名詞*
てんいがくしゅう	転移学習	名詞*
てんそる	テンソル	名詞*
てんそるけいさん	テンソル計算	名詞*
てんそるせききてい	テンソル積基底	名詞*
てんぷ	貼付	名詞*
でぃーぷらーにんぐ	ディープラーニング	名詞*
でぃりくれかくさんき	ディリクレ拡散木	名詞*
でーた	データ	名詞*
でーたあーきてくちゃーかんり	データアーキテクチャー管理	名詞*
でーたえんじにありんぐりょく	データエンジニアリング力	名詞*
でーたかくちょう	データ拡張	名詞*
でーたからのがくしゅう	データからの学習	名詞*
でーたがばなんす	データガバナンス	名詞*
でーたせっと	データセット	名詞*
でーたのせいけい	データの整形	名詞*
でーたのそせい	データの疎性	名詞*
でーたふろーぐらふ	デーフローグラフ	名詞*
でおきしりぼかくさん	デオキシリボ核酸	名詞*
でむらーらいんしゅきてい	デムラー＝ラインシュ基底	名詞*
でるたそく	デルタ則	名詞*
でんどろぐらむ	デンドログラム	名詞*
とっきょほう	特許法	名詞*
とうかかーねる	等価カーネル	名詞*
とうけいてきがくしゅう	統計的学習	名詞*
とうけいてきけっていりろん	統計的決定理論	名詞*
とうけいてきもでりんぐ	統計的モデリング	名詞*
とうけいもでる	統計モデル	名詞*
とくいち	特異値	名詞*
とくいちぶんかい	特異値分解	名詞*
とくいど	特異度	名詞*
とくちょう	特徴	名詞*
とくちょうべくとる	特徴ベクトル	名詞*
とくちょうりょうのちゅうしゅつ	特徴量の抽出	名詞*
とつけいかくもんだい	凸計画問題	名詞*
とつさいてきかもんだい	凸最適化問題	名詞*
とつしゅうごう	凸集合	名詞*
どうけいかんすう	動径関数	名詞*
どうけいきていかんすう	動径基底関数	名詞*
どうけいきていかんすうねっとわーく	動径基底関数ネットワーク	名詞*
どうけいとくちょうしゃぞう	同型特徴写像	名詞*
どうしゅつとくちょうりょう	導出特徴量	名詞*
どくりつせいぶんぶんせき	独立成分分析	名詞*
どくりつどうぶんぷ	独立同分布	名詞*
どくりつへんすう	独立変数	名詞*
どろっぷあうとれいやー	ドロップアウトレイヤー	名詞*
なっぷざっくもんだい	ナップザック問題	名詞*
ないてんほう	内点法	名詞*
にゅーとんほう	ニュートン法	名詞*
にゅーらるねっとわーく	ニューラルネットワーク	名詞*
にゅーろん	ニューロン	名詞*
にゅうりょく	入力	名詞*
にゅうりょくそう	入力層	名詞*
にゅうりょくでーた	入力データ	名詞*
ぬきとり	抜取	名詞*
ねっとわーくず	ネットワーク図	名詞*
のーど	ノード	名詞*
のいずでーた	ノイズデータ	名詞*
のんぱらめとりっくぶーとすとらっぷ	ノンパラメトリックブートストラップ	名詞*
はっけんてきでーたぶんせき	発見的データ分析	名詞*
はっとぎょうれつ	ハット行列	名詞*
はいぶりっどがた	ハイブリッド型	名詞*
はくばんすぷらいん	薄板スプライン	名詞*
はくり	剥離	名詞*
はこひげず	箱ひげ図	名詞*
はずれち	外れ値	名詞*
はますりーくりふぉーどのていり	ハマスリー＝クリフォードの定理	名詞*
はんかごさ	汎化誤差	名詞*
はんかせいのう	汎化性能	名詞*
はんぷくがたとくちょうじょきょほう	反復型特徴除去法	名詞*
はんぷくさいおもみづけさいしょうにじょうほう	反復最重み付け最小二乗法	名詞*
はんぷくひれいすけーりんぐ	反復比例スケーリング	名詞*
はんべつかんすう	判別関数	名詞*
はんべつざひょうじく	判別座標軸	名詞*
はんべつてきおうてきさいきんぼう	判別適応的最近傍	名詞*
はんべつぶんせき	判別分析	名詞*
ばっそくぎょうれつ	罰則行列	名詞*
ばっそくつきかいき	罰則付き回帰	名詞*
ばっそくつきはんべつぶんせき	罰則付き判別分析	名詞*
ばっちがくしゅう	バッチ学習	名詞*
ばいあす	バイアス	名詞*
ばいあすとぶんさんのとれーどおぷ	バイアスと分散のトレードオフ	名詞*
ばいあすぶんさんぶんかい	バイアスー分散分解	名詞*
ばうむうぇるちのあるごりずむ	バウム＝ウェルチのアルゴリズム	名詞*
ばぎんぐ	バギング	名詞*
ばすけっとぶんせき	バスケット分析	名詞*
ばぷにっくちゅるぼねんきすじげん	バプニック＝チェルボネンキス次元	名詞*
ばんのうきんじき	万能近似器	名詞*
ばんぴんぐ	バンピング	名詞*
ばんぷたんさく	バンプ探索	名詞*
ぱーせぷとろん	パーセプトロン	名詞*
ぱーせぷとろんがくしゅうあるごりずむ	パーセプトロン学習アルゴリズム	名詞*
ぱらめーたーがくしゅう	パラメーター学習	名詞*
ぱらめーたーてきごう	パラメーター適合	名詞*
ぱらめとりっくぶーとすとらっぷ	パラメトリックブートストラップ	名詞*
ひかぎゃくあっしゅく	非可逆圧縮	名詞*
ひかんしゅぎてきなせんりゃく	悲観主義的な戦略	名詞*
ひこうぞうかでーた	非構造化データ	名詞*
ひすとぐらむ	ヒストグラム	名詞*
ひとつぬきこうさかくにん	一つ抜き交差確認	名詞*
ひふちぎょうれつぶんかい	非負値行列分解	名詞*
ひみつほじけいやく	秘密保持契約	名詞*
ひるいじどしゃくど	非類似度尺度	名詞*
ひんじそんしつ	ヒンジ損失	名詞*
ひんとんず	ヒントン図	名詞*
ひんどろんてきほうほう	頻度論的方法	名詞*
びじねすりょく	ビジネス力	名詞*
ぴーくしんごうたいざつおんひ	ピーク信号対雑音比	名詞*
ふぁみりーたんいのかごりつ	ファミリー単位の過誤率	名詞*
ふぃっしゃーじょうほうりょう	フィッシャー情報量	名詞*
ふぃっしゃーせんけいはんべつぶんせき	フィッシャー線形判別分析	名詞*
ふぃってぃんぐ	フィッティング	名詞*
ふぃーどふぉわーどにゅーらるねっとわーく	フィードフォワード・ニューラルネットワーク	名詞*
ふくざつど	複雑度	名詞*
ふくざつどぱらめーた	複雑度パラメータ	名詞*
ふごうかき	符号化器	名詞*
ふじゅんど	不純度	名詞*
ふたんりつ	負担率	名詞*
ふへんけいりょう	不変計量	名詞*
ふへんたようたい	不変多様体	名詞*
ふろーさいとめとり	フローサイトメトリ	名詞*
ぶったいけんしゅつ	物体検出	名詞*
ぶーすてぃんぐ	ブースティング	名詞*
ぶーすてぃんぐき	ブースティング木	名詞*
ぶーとすとらっぷ	ブートストラップ	名詞*
ぶぶんいぞんど	部分依存度	名詞*
ぶんかいかのうなもでる	分解可能なモデル	名詞*
ぶんさん	分散	名詞*
ぶんさんかいせき	分散解析	名詞*
ぶんさんしょり	分散処理	名詞*
ぶんしょぶんるい	文書分類	名詞*
ぶんしょようやく	文書要約	名詞*
ぶんぱいかんすう	分配関数	名詞*
ぶんりちょうへいめん	分離超平面	名詞*
ぶんるい	分類	名詞*
ぶんるいき	分類器	名詞*
ぶんるいき	分類木	名詞*
ぶんるいのためのせんけいしゅほう	分類のための線形手法	名詞*
ぶんるいもんだい	分類問題	名詞*
ぷーりんぐそう	プーリング層	名詞*
ぷれーすほるだー	プレースホルダー	名詞*
ぷろくらすてすきょり	プロクラステス距離	名詞*
ぷろくらすてすへいきん	プロクラステス平均	名詞*
ぷろくらすてすへんかん	プロクラステス変換	名詞*
ぷろびっと	プロビット	名詞*
へっせぎょうれつ	ヘッセ行列	名詞*
へいかつうちきりぜったいへんさ	平滑打ち切り絶対偏差	名詞*
へいかつかぎょうれつ	平滑化行列	名詞*
へいかつかすぷらいん	平滑化スプライン	名詞*
へいかつかぱらめーた	平滑化パラメータ	名詞*
へいきんにじょうごさ	平均二乗誤差	名詞*
へいきんばきんじ	平均場近似	名詞*
へんすう	変数	名詞*
へんすうじゅうようど	変数重要度	名詞*
へんすうのしゅるいとようご	変数の種類と用語	名詞*
へんすうへんかん	変数変換	名詞*
べいじあん	ベイジアン	名詞*
べいじあんねっとわーく	ベイジアンネットワーク	名詞*
べいじあんふぃるた	ベイジアンフィルタ	名詞*
べいず	ベイズ	名詞*
べいずあやまりりつ	ベイズ誤り率	名詞*
べいずいんし	ベイズ因子	名詞*
べいずごぶんるいりつ	ベイズ誤分類率	名詞*
べいずじょうほうりょうきじゅん	ベイズ情報量規準	名詞*
べいずすいてい	ベイズ推定	名詞*
べいずにゅーらるねっとわーく	ベイズニューラルネットワーク	名詞*
べいずぶんるいき	ベイズ分類器	名詞*
べいずほう	ベイズ法	名詞*
べきじょうほう	ベキ情報	名詞*
べくとるえんざん	ベクトル演算	名詞*
べんじゃみにほふばーぐほう	ベンジャミニ＝ホフバーグ法	名詞*
ぺーじらんくあるごりずむ	ページランクアルゴリズム	名詞*
ほーるどあうとせっと	ホールドアウト・セット	名詞*
ほそくりつ	捕捉率	名詞*
ほわいとのいず	ホワイトノイズ	名詞*
ぼしゅうだんどうじぶんぷ	母集団同時分布	名詞*
ぼるつまんましん	ボルツマンマシン	名詞*
ぼろのいぶんかつ	ボロノイ分割	名詞*
ぼろのいりょういき	ボロノイ領域	名詞*
ぼんふぇろーにほう	ボンフェローニ法	名詞*
ぽあそんかいき	ポアソン回帰	名詞*
まっくすぷーりんぐ	マックスプーリング	名詞*
まーじん	マージン	名詞*
まーじんき	マージン木	名詞*
まいくろあれいのゆういせいぶんせき	マイクロアレイの有意性分析	名詞*
まえしょり	前処理	名詞*
まえしょりあとしょり	前処理・後処理	名詞*
まえむきざんじしょてきかいき	前向き漸次的回帰	名詞*
ますきんぐこうか	マスキング効果	名詞*
ますきんぐのいずでーた	マスキングノイズデータ	名詞*
まはらのびすきょり	マハラノビス距離	名詞*
まるこふぐらふ	マルコフグラフ	名詞*
まるこふねっとわーく	マルコフネットワーク	名詞*
まるこふれんさもんてかるろ	マルコフ連鎖モンテカルロ	名詞*
みつどかんすう	密度関数	名詞*
みつどすいてい	密度推定	名詞*
みにばっち	ミニバッチ	名詞*
みにばっちがくしゅう	ミニバッチ学習	名詞*
みほんかてい	見本過程	名詞*
むこうぐらふ	無向グラフ	名詞*
むさくいちゅうしゅつじっけん	無作為抽出実験	名詞*
むじょうほうじぜんぶんぷ	無情報事前分布	名詞*
めいきしゃくど	名義尺度	名詞*
めとろぽりすへいすてぃんぐすのあるごりずむ	メトロポリス＝ヘイスティングスのアルゴリズム	名詞*
もくてきへんすう	目的変数	名詞*
もくひょうへんすう	目標変数	名詞*
もじゅーる	モジュール	名詞*
もじれつかーねる	文字列カーネル	名詞*
もでりんぐ	モデリング	名詞*
もでる	モデル	名詞*
もでるせんたく	モデル選択	名詞*
もでるのさまり	モデルのサマリ	名詞*
もでるのふくざつど	モデルの複雑度	名詞*
もでるひょうか	モデル評価	名詞*
もでるへいきん	モデル平均	名詞*
もでるへいきんとすたっきんぐ	モデル平均とスタッキング	名詞*
もんてかるろふぃるた	モンテカルロフィルタ	名詞*
もんてかるろほう	モンテカルロ法	名詞*
ゆうこうぐらふ	有向グラフ	名詞*
ゆうこうじゆうど	有効自由度	名詞*
ゆうこうぱらめーたすう	有効パラメータ数	名詞*
ゆうこうひじゅんかいぐらふ	有向非巡回グラフ	名詞*
ゆうごうがたらっそ	融合型ラッソ	名詞*
ゆうど	尤度	名詞*
ゆうどかんすう	尤度関数	名詞*
ゆうびんばんごう	郵便番号	名詞*
よくせいてききそくどうしゅつほう	抑制的規則導出法	名詞*
よそく	予測	名詞*
よそくてきでーたぶんせき	予測的データ分析	名詞*
よそくでーた	予測データ	名詞*
よそくぶんぷ	予測分布	名詞*
よそくへんすう	予測変数	名詞*
らっかんしゅぎてきなせんりゃく	楽観主義的な戦略	名詞*
らいせんすけいやく	ライセンス契約	名詞*
らいぶらり	ライブラリ	名詞*
らいんしゅけいしき	ラインシュ形式	名詞*
らおのすこあけんてい	ラオのスコア検定	名詞*
らぐらんじゅけいしき	ラグランジュ形式	名詞*
らぐらんじゅじょうすう	ラグランジュ乗数	名詞*
らんだむふぉれすと	ランダムフォレスト	名詞*
りゅうしふぃるた	粒子フィルタ	名詞*
りょうてきへんすう	量的変数	名詞*
りっじかいき	リッジ回帰	名詞*
りっじかんすう	リッジ関数	名詞*
りさんさいてきかもんだい	離散最適化問題	名詞*
りさんへんすう	離散変数	名詞*
りすくいんし	リスク因子	名詞*
りふとち	リフト値	名詞*
りんくかんすう	リンク関数	名詞*
れいによるがくしゅう	例による学習	名詞*
れいりーしょう	レイリー商	名詞*
れこーど	レコード	名詞*
れんぞくさいてきかもんだい	連続最適化問題	名詞*
ろーぜんぶらっと	ローゼンブラット	固有人名*
ろじっと	ロジット	名詞*
ろじすてぃっくかいき	ロジスティック回帰	名詞*
わるどけんてい	ワルド検定	名詞*
